1111111111111
1001000C00001
1000011111001
1001000C00001
1001000000001
10010000C0001
1001000011001
1001000000001
1001000000001
1C010000C0001
1001000000001
1P0011E000001
1111111111111
