111111111111
1001000C00011111
1000011111000001
1C010000C0000001
1001000000011111
1P0011E00001
111111111111
