111111111111111
1P1E000000C1111
111111111111111