111111111
10000C001
1P0000E01
111111111