        1
       101
      100E01
     1C000001
    1000000001
   100P00000001
  11111111111111
